################
#@#            #
# $    .       #
#$$     ..     #
#              #
#              #
#  $    ########
#         ######
#              #
#.  ########   #
#   #      #   #
#   #      #   #
#   #      #   #
#   #      #   #
#   #      #   #
#####      #####
Author: Kevin B. Reilly
Comment:
color blue
Comment-End:
@ : perso
$ : caisse
. : obj
# : mur
