   #####
 ###.   #
##      ###
#  #  #   #
# #    $# #
#   #  @  #
###    ####
  ######
Author: Marwan & Guillaume.
Comment:
color purple
Comment-End:
