########
#       ########
#@$            #
#              #
#  $      $    #
#              #
#  $           #
#              #
#          .   #
#              #
#      .       #
#              #
#              #
#  .       .  *#
#       ########
########
Author: Kevin B. Reilly
Comment:
color red
Comment-End:
