     #####
    ##   #
  ###. $$###
  # *      #
  #.  $ #  #
### .#  # ##
#....#  #$#
## #####  #
 # $ $@$  #
 #   ###  #
 ##### ####
Author: Kevin B. Reilly
Comment:
color yellow
This is a remake of kevin038
Comment-End:
