  #####
### @ ###
#  $ $  #
# #   # #
# .     #
# # .  ##
#      #
####  ##
   ####
Author: Marwan & Guillaume.
Comment:
color yellow
Comment-End:


