 #######
 #     ###
##$#$# $ #
# $  ..# #
#@#$#.$$ ##
# $ .. .. #
####$# .# #
   #  ..  #
   ##$# # #
    #     #
    #######
Author: Kevin B. Reilly
Comment:
color yellow
Comment-End:
