#######
#     ###
# # #  #
#   $.# #
## #$  #
 #@$..# #
 # #   #
 #    # #
 ####   #
    #####
Author: Marwan & Guillaume.
Comment:
color red
Comment-End:
