#######
#     #
#$# # #
# $$  ##
#..*...#
## $$ ##
 ##@  #
  #####
Author: Kevin B. REilly
Comment:
color green
Comment-End:
