    ####
  ###  #
###    #
#  $#*.##
#   ..*+#
# $$#*.##
###   ##
 ##$$ #
 #    #
 #    #
 ######
Author: Kevin B. Reilly
Comment:
color blue
Comment-End:
