 #########
 #   #   #
##$#   # #
#   .#. $##
# #*## *@ #
#  * ##*# #
##$ .#.   #
 # # $ # ##
 #   #   #
 #########
Author: Kevin B. Reilly
Comment:
color green
Comment-End:
