  #####
 ##   ##
## $*  #
#  .#. ##
# #@$ * #
# *$    #
# #   .##
# $*#.##
###   #
  #####
Author: Kevin B. Reilly
Comment:
color purple
Comment-End:
